R 848 480
NO ./textures/Bricks.xpm
SO ./textures/Bricks.xpm
WE ./textures/Wood.xpm
EA ./textures/Wood.xpm

S ./textures/Sprites/barrel.xpm
F 184, 113, 39
C 51, 198, 227

FT ./textures/Wood.xpm
CT ./textures/Bricks.xpm

1111111111
1000000001
1000000201
10000S0001
1000002001
1000220201
1000000001
1111111111
