R 860 480
NO ./textures/Bricks.xpm
SO ./textures/Bricks.xpm
WE ./textures/Wood.xpm
EA ./textures/Wood.xpm

S ./textures/Sprites/pillar.xpm
F 184, 113, 39
C 51, 198, 227

FT ./textures/Bricks.xpm
CT ./textures/Wood.xpm

111111111
111022001
102202221
1020S0201
102000221
110220001
111111111
