R 860 480
NO ./textures/Bricks.xpm
SO ./textures/Bricks.xpm
WE ./textures/theroom.xpm
EA ./textures/Wood.xpm

S ./textures/Sprites/pillar.xpm
F 184, 113, 39
C 51, 198, 227

CT ./textures/Iron.xpm
FT ./textures/Bricks.xpm

111111111
111022001
102202221
1020E0201
102202221
110202001
111111111
