R 640 360
NO ./textures/blue.bpm
SO ./textures/blue.bpm
WE ./textures/blue.bpm
EA ./textures/blue.bpm
F 220, 100, 0
C 225, 30, 0

11111111111111111111
10000000000000000001
10000000000000000001
100000000000N0000001
10000000000000000001
10000000000000000001
11111111111111111111
