R 860 480
NO ./textures/Bricks.xpm
SO ./textures/Bricks.xpm
WE ./textures/Wood.xpm
EA ./textures/Wood.xpm

S ./textures/Sprites/pillar.xpm
F 184, 113, 39
C 51, 198, 227

FT ./textures/Bricks.xpm
CT ./textures/Wood.xpm

111111111
111002001
100000001
1200S0021
100000001
111002001
111111111
