R 848 480
NO ./textures/Bricks.xpm
SO ./textures/Bricks.xpm
WE ./textures/Wood.xpm
EA ./textures/Wood.xpm
S ./textures/Sprites/pillar.xpm
F 184, 113, 39
C 51, 198, 227
FT ./textures/Wood.xpm
CT ./textures/Bricks.xpm
1111111111
1000000001
1010000201
10100S0021
1000000001
1000202001
1000000001
1111111111