R 860 480

NO ./textures/theroom.xpm
SO ./textures/nicolas-cage.xpm
WE ./textures/theroom.xpm
EA ./textures/nicolas-cage.xpm

S ./textures/Sprites/pillar.xpm

F 184, 113, 39
C 51, 198, 227

CT ./textures/Iron.xpm
FT ./textures/Bricks.xpm

111111
11000211
10E001
100001
111111
