R 1920 1080
NO ./textures/Bricks.xpm
SO ./textures/Bricks.xpm
WE ./textures/Bricks.xpm
EA ./textures/Bricks.xpm
S ./textures/Sprites/pillar.xpm

CT ./textures/night2.xpm
FT ./textures/floor.xpm

11111111111111111111111111111
10000011001000000000000000001
10000011001000000000000000001
10001110000000000002000000001
10000000000111110000000020001
10011111111100001002000000001
10000000000000001000000020001
11111111111111111002000000001
10000000112121211000000020001
10000000000000001002000000001
10000000000000001000000000001
10000000112121111002000000001
11110111111111000000000020001
10000000001202020202000000001
100E0000000000000000000020001
10000000001000000000000000001
10000000001202020202020020001
10000000001000000000000000001
11111111111111111111111111111
