R 848 480
NO ./textures/nicolas-cage.xpm
SO ./textures/cthulhu.xpm
WE ./textures/eagle.xpm
EA ./textures/cthulhu.xpm
S textures/sprite_1.xpm

F 184, 113, 39
C 51, 198, 227

11111111111111111111111111111
10000000001100000000000000001
10110000011100000000000010001
100100000001000S0000000000001
10110000011100000000000010001
10000000001100000000011110001
11110111111111000000000010001
11110111111111011101010010001
11000000110101011100000010001
10000000000000001100000010001
10000000000000001100010000001
11000000110101000000000000001
11110111110101000000000000001
10000000001100000100000010001
10000000000000000000000001001
10000000001000010000000001001
10000000001101000000000000001
10000000000100000001010000001
11111111111111111111111111111
