R 860 480

NO ./textures/Bricks.xpm
SO ./textures/Bricks.xpm
WE ./textures/theroom.xpm
EA ./textures/Wood.xpm
S ./textures/Sprites/pillar.xpm

F 184, 113, 39
C 51, 198, 227

CT ./textures/Iron.xpm
FT ./textures/Bricks.xpm

111111111
111000001
1020S0001
100000211
11111111
110200011
111111111
