R 520 360
NO ./cthulhu.xpm
SO ./textures/cthulhu.xpm
WE ./textures/eagle.xpm
EA ./textures/cthulhu.xpm

S ./textures/eagle.xpm
F 50, 50, 0
C 0, 50, 120

1111111111
1000001001
10N1000001
1111000101
1000000001
1000001001
1000111001
1000101001
1000111001
1111111111