R 520 360

NO ./cthulhu.xpm
SO ./textures/cthulhu.xpm
WE ./textures/eagle.xpm
EA ./textures/cthulhu.xpm

S ./textures/eagle.xpm
F 184, 113, 39
C 51, 198, 227

1111111111
1000001001
10010W0001
1111000101
1000000001
1000001001
1000111001
1111111111
