R 848 480

NO ./Textures/Bricks.xpm
SO ./Textures/Bricks.xpm
WE ./Textures/Wood.xpm
EA ./Textures/Wood.xpm

S ./Textures/Sprites/pillar.xpm
F 184, 113, 39
C 51, 198, 227

CT ./Textures/cthulhu.xpm
FT ./Textures/Glass.xpm

1111111111
1200000001
1010000201
10100S0001
1000000001
1000002001
1000000001
1111111111
