R 860 480

NO ./textures/Bricks.xpm
SO ./textures/Bricks.xpm
WE ./textures/theroom.xpm
EA ./textures/Wood.xpm

S ./textures/Sprites/pillar.xpm
F 184, 113, 39
C 51, 198, 227

CT ./textures/Iron.xpm
FT ./textures/Bricks.xpm

111111111
111000001
102000001
100000211
102E011	  	
110202011
111111111
