R 1920 1080
NO ./cthulhu.xpm
SO ./textures/cthulhu.xpm
WE ./textures/eagle.xpm
EA ./textures/cthulhu.xpm


S
F 220, 100, 0
C 225, 30, 0

1111111111
1000000001
100000N001
1000000001
1111111111