R 520 360
NO ./cthulhu.xpm
SO ./textures/cthulhu.xpm
WE ./textures/eagle.xpm
EA ./textures/cthulhu.xpm

S ./textures/eagle.xpm
F 220, 100, 0
C 225, 30, 0

1111111111
1000001001
1001000001
1111000101
1000000001
1000000001
10000N0001
1000000001
1000000001
1111111111