R 848 480

NO ./textures/Wall1.xpm
SO ./textures/Wall2.xpm
WE ./textures/Wall3.xpm
EA ./textures/Wall4.xpm

S ./textures/eagle.xpm
F 184, 113, 39
C 51, 198, 227

FT ./textures/Wall1.xpm
CT ./textures/Wall2.xpm

1111111111
1000000001
1010000001
10100S0001
1000000001
1000000001
1000000001
1111111111
